11111111111111111111
1C00000M0000CEC00001
10001000C0M000100M01
10101110000000100C01
111C111111M000100M01
100C0M00001110001111
1M0000000000111000C1
1001111111100M000001
1000C000000000000001
11111101111000111111
10P0000000000000C001
11111111111111111111
