11111111111111111
1C00000M000C1E001
10001000C00010001
10101000000010C01
11111111100010001
100C0000001111111
1M0000000000000C1
1001111111100M001
10000000000000001
11111101111111111
10P0000000000C001
11111111111111111
