11111111111111111
1C0000M0000000E01
10001000000010001
10101000000010001
111111111000100C1
100C0000001111111
1000000000000M0C1
1M011111111000001
10000000000000001
11111101111111111
10P0000000000C001
11111111111111111
