11111111111111111
1C000000000000E01
10001000000010001
1T101000000010001
111111111000100C1
100C0000001111111
100000000000000C1
10011111111000001
10000000000000001
11111101111111111
10P0000000000C001
11111111111111111
