11111111111111111
10000000000000E11
10001000000010101
10101000000010001
11111111100010001
11000000001111111
1C100000000000001
11011111111000001
1000000000000C011
11111101111111111
10P00000000000001
11111111111111111
