11111111111111111
10000000000000E01
10001000000010001
10101000000010001
11111111100010001
10000000001111111
10000000000000C01
10011111111000001
10000000000000001
11111101111111111
100000000P0000001
11111111111111111
